R 1920 1080
NO ./Texture/cat.xpm
SO ./Texture
WE ./Texture
EA ./Texture

S ./sprite
F 255,415,452
C 625,2,0

111111111111111
100000000000001
100000000000001
100001110000001
100000N00000001
100000000000001
100000000000001
111111111111111
