R 920 720
NO ./Assets/unnamed.xpm
SO ./Assets
WE ./Assets
EA ./Assets

S ./Assets
F 255,415,452
C 625,2,0

11111111111111
111000111110001
111000011100001
111000001000001
11110000000001
11111000N0001
111111000001
11111110001
1111111101
111111111