R 1500 700
NO ./Assets/unnamed.xpm
SO ./Assets
WE ./Assets
EA ./Assets

S ./Assets
F 0,255,0
C 0,0,255

111111111111111111111111111111111
111111100000000000001111111111111
111100000000000000000000000111111
110000000000000000000000000000001
100000000000000000000000000000001
100000000000000000000000000000001
1000000000000000000000000000000011
1000000000000000000000000000000011
1000000000000000000000000000E000001
10000000000000000000000000000000001
10000000000000000000000000000000001
11111111111111111111111111111111111